11111111
1C0P01E1
100C0001
11111111
