1111111111111
1C0P01E000001
100C000000001
1000000000001
1000000000001
1000000100001
1000000100001
1111111111111
