11111111
100P01E1
100C0001
11111111
