1111111111111
1C0P01E000G01
100C000000001
1000000000001
100G0000G0G01
1G00000100001
1000000100001
1111111111111
