11111111
1CCCCCE1
1CCPCCC
11111111
